4,0,0,0,0,0,4,0,0
4,4,4,4,1,2,4,0,0
0,0,4,0,4,0,4,1,0
0,2,4,0,4,0,0,4,4
0,4,4,0,4,4,4,4,0
4,4,1,0,1,2,4,1,0
4,0,0,0,0,0,4,2,0
4,2,4,4,4,4,4,4,4
4,0,0,4,4,4,0,0,0
,,,,,,,,
"0 = オブジェクト
1 = 取得可能アイテム
2 = 敵
4 = 空白",,,,,,,,
,,,,,,,,
,,,,,,,,
,,,,,,,,
,,,,,,,,
,,,,,,,,
,,,,,,,,
